%%%%%%%%%%%%%%
%          G %
%%%%%%%%     %
%            %
%       .    %
%            %
%           .%
%P           %
%%%%%%%%%%%%%%
% % % %%%%%%%%
%%%%%%%%%%%%%%
