%%%%%%%%%%%%%%
%            %
%     G  .   %
%            %
%  %%%%%%%%%%%
%  %         %
%  % .   P   %
%  %         %
%            %
%%%%%%%%%%%%%%
% % % % %%%%%%
%%%%%%%%%%%%%%
