%%%%%%%%%%%%%%
% G          %
%%%%%%%%     %
%            %
%            %
%            %
%            %
%P           %
%%%%%%%%%%%%%%
% % % %%%%%%%%
%%%%%%%%%%%%%%
