%%%%%%%%%%%%%%
%G           %
%%%%%%       %
%..       %%%%
%%%%         %
%            %
%%%%         %
%           P%
%%%%%%%%%%%%%%
% % % %%%%%%%%
%%%%%%%%%%%%%%
