%%%%%%%%%%%%%%
%           P%
%       %%%%%%
%          ..%
%      .  %%%%
%         %  %
%         %  %
%         %  %
%         %  %
%         %  %
%         %  %
%         %  %
%G           %
%%%%%%%%%%%%%%
% % % %%%%%%%%
%%%%%%%%%%%%%%
